44144414444111
14141414114111
14141414114111
14141414114111
14141414114111
14141414114111
14441444114411
11111111111111
